40 22
****************************************
*###### ##d#r ######r#r######### ##r###*
*#rAr###### ##########rd##r###### ### #*
*########## ##r######r#r##r########r###*
*r#rr#########r#######r#######r###r####*
*r# r######### r##r#########r######r#rr*
*### ##r########r######r# r########r#rr*
*******************************####r##r*
*# ###r##d# ##r#r##########d#rd####### *
*##d#####r##### ########rr r##r#####r##*
*###r##r#r##############r #r##r########*
*#r#####r########rrr#######r## #d####r#*
*#d## ##r#  #####r#rd# d ###r###r##d# #*
*# r##############r r##r########d#####r*
*########*******************************
* r#########r###d####r#####r###r#######*
* r######### r##r########r##  ##r#rr###*
*# ##r########r#####r#  #### b##r#rr###*
*####rd##r########r######r#rd######r###*
*### ##r# ##r#rr#########r#rd######    *
*#d#### ##### ######### #r##r####r## q *
****************************************