17 10
*****************
*    S  S  S    *
*       *       *
*               *
*   *b*         *
*               *
*               *
*               *
*q            p *
*****************