17 10
*****************
*    S     S    *
*               *
*       s       *
*    s          *
*               *
*               *
*               *
*q            p *
*****************