7 6
*******
*A *  *
*   * *
* *   *
* *  q*
*******