11 5
***********
*r*S*d*s***
* * * * *S*
*b*b*b*b*b*
***********